WE src/xpm/west.xpm
SO src/xpm/south.xpm
EA src/xpm/east.xpm
NO src/xpm/north.xpm


C 135,206,235
F 119,136,153

111111111111111111111
1000000000000000000E1
111111111111111111111