WE src/xpm/west.xpm
SO src/xpm/south.xpm
EA src/xpm/east.xpm
NO src/xpm/north.xpm
C 135,206,235
F 119,136,155








111111
111111
111111
111
111                11111
1111111111111111111111111111111
1000000000000000000000000000001
1000000000000000000000000000001111
1000000000000000000000000000001    
1000000000000000000000000000001
1000000000000000000000000000001    
1000000000000000000000000000001
100000000000000000000000000000111111
1000000000000000000000000000001
1000000000010000000000000000001
1000000000010000000000000000001
1000000000000000000000000000001
1000000000000000000000000000001
1000000011111000000000000000001      
1000000000000000000000011110001
1000000000000000000000000000001
10000000000000000000000000100N1
1111111111111111111111111111111