WE src/xpm/west.xpm
SO src/xpm/south.xpm
EA src/xpm/east.xpm
NO src/xpm/north.xpm


C 135,206,235
F 119,136,153
   
   

      
11111111
10000001         
1000N001       
11111111        
11111111        